11111111111111
100000000C0001
100C0000111111
1000P000000001
1000C00111C1E1
111111111111111