11111111111111
100000000C0001
100C0000111111
1000P0000G0001
1000C00111C101
11111111111111