1111111111111111
1E00000000000001
1C00010100100101
1110010010101101
1P1000000C00C1C1
1111111111111111