1111111111
1P000CE011
1111111111