1111111111111111
1E00000000000001
1010010100100101
1110010010101101
1P0000000C00C0C1
1111111111111111