1111111
1E00011
1100001
1110001
1P00C11
1111111