1111111111
1PE00C0011
1111111111