11111111111
101P0000001
1111C000001
1111E000001
11111111111