11111111111
101P000C001
1010000C0E1
1010000C001
1010000C001
1010000C001
1010000C001
1010000C001
1010000C001
1010000C001
1010000C001
1010000C001
1010000C001
1010000C001
1010000C001
1010000C001
1010000C001
1010000C001
1010000C001
1010000C001
1010000C001
1010000C001
1010000C001
1010000C001
1010000C001
1010000C001
1010000C001
1010000C001
1010000C001
1010000C001
1010000C001
1010000C001
1010000C001
1010000C001
1010000C001
1010000C001
1010000C001
1010000C001
1010000C001
1010000C001
1010000C001
1010000C001
1010000C001
1010000C001
1010000C001
1010000C001
1010000C001
1010000C001
1010000C001
1010000C001
1010000C001
1010000C001
1010000C001
1010000C001
1010000C001
1010000C001
1010000C001
1010000C001
1010000C001
1010000C001
1010000C001
1010000C001
1010000C001
1010000C001
1010000C001
1010000C001
1010000C001
1010000C001
1010000C001
1010000C001
1010000C001
1010000C001
1010000C001
1010000C001
1010000C001
1010000C001
1010000C001
1010000C001
1010000C001
1010000C001
1010000C001
1010000C001
1010000C001
1010000C001
1010000C001
1010000C001
1010000C001
1010000C001
1010000C001
1010000C001
1010000C001
1010000C001
1010000C001
1010000C001
1010000C001
1010000C001
1010000C001
1010000C001
1010000C001
1010000C001
1010000C001
1010000C001
1010000C001
1010000C001
1010000C001
1010000C001
1010000C001
1010000C001
1010000C001
1010000C001
1010000C001
1010000C001
1010000C001
1010000C001
1010000C001
1010000C001
1010000C001
1010000C001
1010000C001
1010000C001
1010000C001
1010000C001
1010000C001
1010000C001
1010000C001
1010000C001
1010000C001
1010000C001
1010000C001
1010000C001
1010000C001
1010000C001
1010000C001
1010000C001
1010000C001
1010000C001
1010000C001
1010000C001
1010000C001
1010000C001
1010000C001
1010000C001
1010000C001
1010000C001
1010000C001
1010000C001
1010000C001
1010000C001
1010000C001
1010000C001
1010000C001
1010000C001
1010000C001
1010000C001
1010000C001
1010000C001
1010000C001
1010000C001
1010000C001
1010000C001
1010000C001
1010000C001
1010000C001
1010000C001
1010000C001
1010000C001
1010000C001
1010000C001
1010000C001
1010000C001
1010000C001
1010000C001
1010000C001
1010000C001
1010000C001
1010000C001
1010000C001
1010000C001
1010000C001
1010000C001
1010000C001
1010000C001
1010000C001
1010000C001
1010000C001
1010000C001
1010000C001
1010000C001
1010000C001
1010000C001
1010000C001
1010000C001
1010000C001
1010000C001
1010000C001
1010000C001
1010000C001
1010000C001
1010000C001
1010000C001
1010000C001
1010000C001
1010000C001
1010000C001
1010000C001
11111111111
