1111111111111111
1E00000000000001
1100010100100101
1110010010101101
1P0000000C00C1C1
1111111111111111