111111111111111
10P000000000001
100000000000001
100000000000001
100000000000C01
100000000C000E1
111111111111111