111111111111111111111111111111111111111
1001000000010000000100000000000000000C1
1C0001111C0001111C000111110101010101001
100011000000110000001100000000000000001
1001000000010000000100000000000000000C1
1C0001111C0001111C000111110101010101001
100011000000110000001100000000000000001
10010000000100000P0100000000000000000C1
1C0001111C0001111C000111110101010101001
100011000000110000001100000000000000001
1001000000010000000100000000000000000C1
1C0001111C0001111C101111110101010101001
100011000000110000011100000000000000001
1C0001111C0001111C101111110101010101001
100011000000110000011100000000000000001
1C0001111C0001111C101111110101010101001
100011000000110000011100000000000000001
1C0001111C0001111C101111110101010101001
100011000000110000011100000000000000001
1C0001111C0001111C101111110101010101001
10001100000E110000011100000000000000001
111111111111111111111111111111111111111