1111111111111
1P00C0E010001
1111111111111