1111111111111
1P000E01C0001
1000000000001
1111111111111