11111111111111111111111111111111
1CC0001111C101111110101010101001
10000000000000000000000000P00001
1CC0001111C101111110101010101001
10000110000011100000000000000001
1CC0001111C101111110101010101001
1000E110000011100000000000000011
11111111111111111111111111111111