1111111111111
1P000EC010001
1111111111111