1111111111111
1P00CE0100001
1111111111111