1111111111111111111111111111111111111111
10C0011111011101110111011101110111111001
10C0000000011101110111011101110111111001
1000011111011101110111011101110111111001
1000011111011101110111011101110111111001
10C0011111011101110111011101110111111001
1000011111011101110111011101110111111001
1000011111011101110111011101110111111001
100C011111011101110111011101110111111001
1000011111C111C111C111C111C111C111111C01
1000011111011101110111011101110111111001
100C011111011101110111011101110111111001
1C00011111011101110111011101110111111001
1P0011E00000000000CCCCCCCCCCCCCC00000001
1111111111111111111111111111111111111111