1111111111111
1P00C0E000001
1111111111111