1111111111111
1P00C0E000000
1000C00000001
1000C000V0001
1111111111111